MAP INFO
x=150
y=100
z=1
END MAP INFO
MAP DATA
------------------------------------------------------------------------------------------------------------------------------------------------------
------------------------------------------------------------------------------------------------------------------------------------------------------
||..................................................................................................................................................||
||..................................................................................................................................................||
||..................................................................................................................................................||
||..................................................................................................................................................||
||..................................................................................................................................................||
||..................................................................................................................................................||
||..................................................................................................................................................||
||..............-----------------------......----------------------------------------------------------.............................................||
||..............|.....................|......----------------------------------------------------------.............................................||
||..............|.....................|......||......................................................||.............................................||
||..............|.....................|......||......................................................||.............................................||
||..............|.....................|......||......................................................||.............................................||
||..............|.....................|......||......................................................||.............................................||
||..............|.....................|......||......................................................||.............................................||
||..............|.....................|......||......................................................||.............................................||
||..............|.....................|......---------------------------------------.................||.............................................||
||..............-----------------------......---------------------------------------.................||.............................................||
||................................................................................||.................||.............................................||
||................................................................................||.................||.............................................||
||................................................................................||.................||.............................................||
||..............................-------------------...............................||.................||.............................................||
||..............................|.................|...............................||.................||.............................................||
||..............................|.................|...............................||.................||.............................................||
||..............................|.................|...............................||.................||.............................................||
||..............................|.................|...............................||.................||.............................................||
||..............-----------------.................--------------..................---------------------.............................................||
||..............|..............................................|....................................................................................||
||..............|..............................................|....................................................................................||
||..............|..............................................|....................................................................................||
||..............|..............................................|....................................................................................||
||..............|..............................................|....................................................................................||
||..............|..............................................|....................................................................................||
||..............------------------------------------------------....................................................................................||
||.................................................................................-------------..................-------------.....................||
||.................................................................................-------------..................-------------.....................||
||.................................................................................||.........||..................||.........||.....................||
||.................................................................................||.........||..................||.........||.....................||
-------------------------------------------------------------------------------------.........||..................||.........||-----------------------
-------------------------------------------------------------------------------------.........||..................||.........||-----------------------
...................................................................................||.........||..................||.........||.......................
...................................................................................||.........||..................||.........||.......................
...................................................................................-------------..................-------------.......................
...................................................................................-------------..................-------------.......................
......................................................................................................................................................
......................................................................................................................................................
......................................................................................................................................................
......................................................................................................................................................
......................................................................................................................................................
......................................................................................................................................................
}}}}}}}}}}}}}.........................................................................................................................................
}}}}}}}}}}}}}}}}}}}}}}................................................................................................................................
}}}}}}}}}}}}}}}}}}}}}}}}}}}...........................................................................................................................
}}}}}}}}}}}}}}}}}}}}}}}}}}}}}}}}}}}}}}}}}}}}}}........................................................................................................
}}}}}}}}}}}}}}}}}}}}}}}}}}}}}}}}}}}}}}}}}}}}}}}}}}}}}}}}..............................................................................................
}}}}}}}}}}}}}}}}}}}}}}}}}}}}}}}}}}}}}}}}}}}}}}}}}}}}}}}}}}}}}}........................................................................................
}}}}}}}}}}}}}}}}}}}}}}}}}}}}}}}}}}}}}}}}}}}}}}}}}}}}}}}}}}}}}}}}}}}}..................................................................................
}}}}}}}}}}}}}}}}}}}}}}}}}}}}}}}}}}}}}}}}}}}}}}}}}}}}}}}}}}}}}}}}}}}}}}}}}}}}}}}}}}....................................................................
}}}}}}}}}}}}}}}}}}}}}}}}}}}}}}}}}}}}}}}}}}}}}}}}}}}}}}}}}}}}}}}}}}}}}}}}}}}}}}}}}}}}}}}}}}}}..........................................................
}}}}}}}}}}}}}}}}}}}}}}}}}}}}}}}}}}}}}}}}}}}}}}}}}}}}}}}}}}}}}}}}}}}}}}}}}}}}}}}}}}}}}}}}}}}}}}................................................}}}}}}}}
}}}}}}}}}}}}}}}}}}}}}}}}}}}}}}}}}}}}}}}}}}}}}}}}}}}}}}}}}}}}}}}}}}}}}}}}}}}}}}}}}}}}}}}}}}}}}}}}.......................................}}}}}}}}}}}}}}}
}}}}}}}}}}}}}}}}}}}}}}}}}}}}}}}}}}}}}}}}}}}}}}}}}}}}}}}}}}}}}}}}}}}}}}}}}}}}}}}}}}}}}}}}}}}}}}}}}}}}}................................}}}}}}}}}}}}}}}}}
}}}}}}}}}}}}}}}}}}}}}}}}}}}}}}}}}}}}}}}}}}}}}}}}}}}}}}}}}}}}}}}}}}}}}}}}}}}}}}}}}}}}}}}}}}}}}}}}}}}}}}}..+++++++++++...............}}}}}}}}}}}}}}}}}}}
}}}}}}}}}}}}}}}}}}}}}}}}}}}}}}}}}}}}}}}}}}}}}}}}}}}}}}}}}}}}}}}}}}}}}}}}}}}}}}}}}}}}}}}}}}}}}}}}}}}}}}}}}+++++++++++}}}}}}}}}}}}}}}}}}}}}}}}}}}}}}}}}}
}}}}}}}}}}}}}}}}}}}}}}}}}}}}}}}}}}}}}}}}}}}}}}}}}}}}}}}}}}}}}}}}}}}}}}}}}}}}}}}}}}}}}}}}}}}}}}}}}}}}}}}}}+++++++++++}}}}}}}}}}}}}}}}}}}}}}}}}}}}}}}}}}
}}}}}}}}}}}}}}}}}}}}}}}}}}}}}}}}}}}}}}}}}}}}}}}}}}}}}}}}}}}}}}}}}}}}}}}}}}}}}}}}}}}}}}}}}}}}}}}}}}}}}}}}}+++++++++++}}}}}}}}}}}}}}}}}}}}}}}}}}}}}}}}}}
}}}}}}}}}}}}}}}}}}}}}}}}}}}}}}}}}}}}}}}}}}}}}}}}}}}}}}}}}}}}}}}}}}}}}}}}}}}}}}}}}}}}}}}}}}}}}}}}}}}}}}}}}+++++++++++}}}}}}}}}}}}}}}}}}}}}}}}}}}}}}}}}}
}}}}}}}}}}}}}}}}}}}}}}}}}}}}}}}}}}}}}}}}}}}}}}}}}}}}}}}}}}}}}}}}}}}}}}}}}}}}}}}}}}}}}}}}}}}}}}}}}}}}}}}}}+++++++++++}}}}}}}}}}}}}}}}}}}}}}}}}}}}}}}}}}
}}}}}}}}}}}}}}}}}}}}}}}}}}}}}}}}}}}}}}}}}}}}}}}}}}}}}}}}}}}}}}}}}}}}}}}}}}}}}}}}}}}}}}}}}}}}}}}}}}}}}}}}}+++++++++++}}}}}}}}}}}}}}}}}}}}}}}}}}}}}}}}}}
}}}}}}}}}}}}}}}}}}}}}}}}}}}}}}}}}}}}}}}}}}}}}}}}}}}}}}}}}}}}}}}}}}}}}}}}}}}}}}}}}}}}}}}}}}}}}}}}}}}}}}}}}+++++++++++}}}}}}}}}}}}}}}}}}}}}}}}}}}}}}}}}}
}}}}}}}}}}}}}}}}}}}}}}}}}}}}}}}}}}}}}}}}}}}}}}}}}}}}}}}}}}}}}}}}}}}}}}}}}}}}}}}}}}}}}}}}}}}}}}}}}}}}}}}}}+++++++++++}}}}}}}}}}}}}}}}}}}}}}}}}}}}}}}}}}
}}}}}}}}}}}}}}}}}}}}}}}}}}}}}}}}}}}}}}}}}}}}}}}}}}}}}}}}}}}}}}}}}}}}}}}}}}}}}}}}}}}}}}}}}}}}}}}}}}}}}}}}}+++++++++++}}}}}}}}}}}}}}}}}}}}}}}}}}}}}}}}}}
}}}}}}}}}}}}}}}}}}}}}}}}}}}}}}}}}}}}}}}}}}}}}}}}}}}}}}}}}}}}}}}}}}}}}}}}}}}}}}}}}}}}}}}}}}}}}}}}}}}}}}}}}+++++++++++}}}}}}}}}}}}}}}}}}}}}}}}}}}}}}}}}}
}}}}}}}}}}}}}}}}}}}}}}}}}}}}}}}}}}}}}}}}}}}}}}}}}}}}}}}}}}}}}}}}}}}}}}}}}}}}}}}}}}}}}}}}}}}}}}}}}}}}}}}}}+++++++++++}}}}}}}}}}}}}}}}}}}}}}}}}}}}}}}}}}
}}}}}}}}}}}}}}}}}}}}}}}}}}}}}}}}}}}}}}}}}}}}}}}}}}}}}}}}}}}}}}}}}}}}}}}}}}}}}}}}}}}}}}}}}}}}}}}}}}}}}}}}}+++++++++++}}}}}}}}}}}}}}}}}}}}}}}}}}}}}}}}}}
............................}}}}}}}}}}}}}}}}}}}}}}}}}}}}}}}}}}}}}}}}}}}}}}}}}}}}}}}}}}}}}}}}}}}}}}}}}}}}}+++++++++++}}}}}}}}}}}}}}}}}}}}}}}}}}}}}}}}}}
...................................}}}}}}}}}}}}}}}}}}}}}}}}}}}}}}}}}}}}}}}}}}}}}}}}}}}}}}}}}}}}}}}}}}}}}}+++++++++++}}}}}}}}}}}}}}}}}}}}}}}}}}}}}}}}}}
......................................}}}}}}}}}}}}}}}}}}}}}}}}}}}}}}}}}}}}}}}}}}}}}}}}}}}}}}}}}}}}}}}}}}}+++++++++++}}}}}}}}}}}}}}}}}}}}}}}}}}}}}}}}}}
....................................................................}}}}}}}}}}}}}}}}}}}}}}}}}}}}}}}}}}}}}+++++++++++}}}}}}}}}}}}}}}}}}}}}}}}}}}}}}}}}}
......................................................................................}}}}}}}}}}}}}}}}}}}+++++++++++}}}}}}}}}}}}}}}}}}}}}}}}}}}}}}}}}}
....................................................................................................}}}}}+++++++++++}}}}}}}}}}}}}}}}}}}}}}}}}}}}}.....
.........................................................................................................+++++++++++..................................
......................................................................................................................................................
......................................................................................................................................................
......................................................................................................................................................
......................................................................................................................................................
......................................................................................................................................................
......................................................................................................................................................
......................................................................................................................................................
......................................................................................................................................................
......................................................................................................................................................
......................................................................................................................................................
......................................................................................................................................................
......................................................................................................................................................
......................................................................................................................................................
......................................................................................................................................................
......................................................................................................................................................
......................................................................................................................................................
......................................................................................................................................................
END MAP DATA
